............
.....A......
.....A......
..0.........
...0........
......A.....
............
..A.........
.......0....
........0...
......A.....
............
