............
....A.......
.....A......
...A.A......
............